+--+--+--+--+
|           |
+  +--+--+--+
|  |        |
+  +  +--+--+
|     |     | 
+--+  +  +--+
|  |     |  |
+--+--+--+--+