+--+--+--+--+
|           |
+--++--+-+  +
|           |
+  +  +  +  +
|| |  || |  |
+  +--+  +--+
|g |--| -|--|
+--+--+--+--+
